..............
.=............
.==...........
.==...........
=.............
==............
.=............
.=............
.=............
.=............
.==......=....
..=......=....
===.....=.....
===....=......
.==...=.......
....==........
....=.........
..==..........
.==...........
..............
......=.......
.....=........
....==........
..===.........
.==...........
.=............
.=............
.==...........
..=...........
..==..........
..==..........
..===.........
..=.=.........
..===.........
.......=......
.......==.....
.......=.=....
.......=.=....
.......==.=...
.......====...
.......=......
..............
..............
..............
..............
..............
..............
..............
..............
..............
..............
....=...=.....
....=...=.....
....=...=.....
....=..=......
....=.=.......
....==........
....==........
....===.......
.....==.......
......=.......
..............
.......=......
.......=......
........=.....
........=.....
...=.....=....
....=....=....
....=..===....
....=...=.....
....=.........
....=.........
..............
..............
..............
..............
..............
..............
..............
.....=........
......=.......
......=.......
......==......
.......=......
......=.=.....
........=.....
......=.......
......=.......
......=.......
.....==.......
.....=........
...=.=........
...=..=.......
...=..=.......
....===.......
..............
..............
..............
..............
..............
..............
..............
..............
..............
..............
..............
..====..=.....
..=..====.....
..=...........
..=...........
.=............
.=............
.=............
.=............
..=...........
..=...........
..=...........
...=..........
...=..........
...=..........
...=..........
....=.........
....=.........
.....=........
.....=........
.....==.......
......=.......
......=.......
.......=......
.......=......
.....===......
...===........
...=..........
...=..........
....=.........
....==........
.....==.......
..............
..............
..............
..............
..............
..............
..............
..............
..............
..............
..............
..............
..............
..............
..............
..............
..............
..............
..............
..............
..............
..............
..............
..............
..............
..............
..............
..............
..............
..............
..............
..............
..............
..............
..............
..............
..............
..............
..............
..............
..............
..............
..............
..............
..............
..............
..............
..............
..............
..............
..............
..............
..............
..............
..............
..............
..............
..............
..............
..............
..............
..............
..............
..............
..............
..............
.=............
=.==..........
.=.==.........
.==.=.........
..=.==........
..=...........
..=..=........
..=...=.......
..=..==.......
..=.====......
..=.=..=......
.===....=.....
.=.=..=.=.....
.=..=.==.=....
.=..=...==....
.==.=.=.==....
..=.=.=..=....
..=.=....=....
..=.=.....=...
..=.=.=..==...
.=..=..===....
.=..=..===....
.=..===.=.....
..=====.==....
..==.....=....
...==.........
...==.........
..............
..............
..............
..............
..............
..............
..............
..............
..............
..............
..............
..............
..............
....====......
.....=........
.....==.......
......=.......
..............
..............
..............
..............
..............
..............
..............
..............
..............
..............
..............
..............
..............
..............
..............
..............
..............
..............
..............
..............
..............
..............
..............
..............
..............
..............
..............
..............
..............
..............
..............
..............
..............
..............
..............
..............
..............
..............
..............
..............
..............
..............
..............
..............
..............
..............
..............
..............
..............
..............
..............
..............
..............
##xxxxxxxxxxxx
##Qxxxxxxxxxxx
##Qxxxxxxxxxxx
##Qxxxxxxxxxxx
##Qxxxxxxxxxxx
##Qxxxxxxxxxxx
##Qxxxxxxxxxxx
##xxxxxxxxxxxx
##xxxxxxxxxxxx
xQxxxxxxxxxxxx
xQQxxxxxxxxxxx
xxxxxxxxxxxxxx
xxxxxxxxxxxxxx
xxxxxxxxxxxxxx
xxxxxxxxxxxxxx
xxxxxxxxxxxxxx
xxxxxxxxxxxxxx
xxxxxxxxxxxxxx
xxxxxxxxxxxxxx
xxxxxxxxxxxxxx
xxxxxxxxxxxxxx
xxxxxxxxxxxxxx
xxxxxxxxxxxxxx
xxxxxxxxxxxxxx
xxxxxxxxxxxxxx
xxxxxxxxxxxxxx
xxxxxxxxxxxxxx
xxxxxxxxxxxxxx
xxxxxxxxxxxxxx
xxxxxxxxxxxxxx
xxxxxxxxxxxxxx
xxxxxxxxxxxxxx
xxxxxxxxxxxxxx
xxxxxxxxxxxxxx
xxxxxxxxxxxxxx
xxxxxxxxxxxxxx
xxxxxxxxxxxxxx
xxxxxxxxxxxxxx
xxxxxxxxxxxxxx
xxxxxxxxxxxxxx
xxxxxxxxxxxxxx
xxxxxxxxxxxxxx
xxxxxxxxxxxxxx
xxxxxxxxxxxxxx
xxxxxxxxxxxxxx
xxxxxxxxxxxxxx
xxxxxxxxxxxxxx
xxxxxxxxxxxxxx
xxxxxxxxxxxxxx
xxxxxxxxxxxxxx
xxxxxxxxxxxxxx
xxxxxxxxxxxxxx
xxxxxxxxxxxxxx
xxxxxxxxxxxxxx
xxxxxxxxxxxxxx
xxxxxxxxxxxxxx
xxxxxxxxxxxxxx
xxxxxxxxxxxxxx
xxxxxxxxxxxxxx
xxxxxxxxxxxxxx
xxxxxxxxxxxxxx
xxxxxxxxxxxxxx
xxxxxxxxxxxxxx
xxxxxxxxxxxxxx
xxxxxxxxxxxxxx
xxxxxxxxxxxxxx
xxxxxxxxxxxxxx
xxxxxxxxxxxxxx
xxxxxxxxxxxxxx
xxxxxxxxxxxxxx
xxxxxxxxxxxxxx
xxxxxxxxxxxxxx
xxxxxxxxxxxxxx
xxxxxxxxxxxxxx
xxxxxxxxxxxxxx
xxxxxxxxxxxxxx
xxxxxxxxxxxxxx
xxxxxxxxxxxxxx
xxxxxxxxxxxxxx
xxxxxxxxxxxxxx
xxxxxxxxxxxxxx
xxxxxxxxxxxxxx
xxxxxxxxxxxxxx
xxxxxxxxxxxxxx
xxxxxxxxxxxxxx
xxxxxxxxxxxxxx
xxxxxxxxxxxxxx
xxxxxxxxxxxxxx
xxxxxxxxxxxxxx
xxxxxxxxxxxxxx
xxxxxxxxxxxxxx
xxxxxxxxxxxxxx
xxxxxxxxxxxxxx
xxxxxxxxxxxxxx
xxxxxxxxxxxxxx
xxxxxxxxxxxxxx
xxxxxxxxxxxxxx
xxxxxxxxxxxxxx
xxxxxxxxxxxxxx
xxxxxxxxxxxxxx
